# ###################
#             #     #
# # ## #### # # ### #
# # #   #       # # #
# # ##### # # ### # #
# #     #   #   # # #
# ### ######### # # #
#         # #   #   #
#   # ##### # # ### #
#   # # # #   # #   #
# ##### # # ### ### #
#       # # #   #   #
# ##### # ### ### # #
# #   # #       # # #
### # # # ##### # ###
#   # # # #   # #   #
# ##### # # ### ### #
#       # # #   #   #
# ####### # # ### # #
#   #     #       # #
##### ###############
