# ###################
# ################# #
# ################# #
# ################# #
# ################# #
# ################# #
# ################# #
# ################# #
# ################# #
# ################# #
# ################# #
# ################# #
# ################# #
# ################# #
# ################# #
# ################# #
# ################# #
# ################# #
#                   #
##### ###############
